AC - Avery is WikiWiki!

AR - The 123 Hawaii WikiWiki significa "rápido", chabî!

AU - "In Hawaii WikiWiki is quick mate!"

AZ - "Wiki is Wikid Cool"

BALINESE - Wikiwiki artinipun "enggal pisan"

BANGLA - Hawaii'er bhashaye, tara-tari ke bole "WikiWiki"

BC - BakChodhi

BR - WikiWiki a palavra havaiana para rápido.

LB - Trying to figure it all out.

Nabih tests wiki

אני כותב בעברית

BURMESE - WikiWiki so da Hawaiian lo "Myan Myan".

CB - I am groovin on WiKi.

BY - WikiWiki hoast "gschwind" bei de Hawajana.

CA - WikiWiki is "quick" in yer Hawaiian there, eh.

CA - WikiWiki vol dir "ràpid" en Hawaià?

CO - Wiki is Qwi''''''Ki

CH - WikiWiki beduetet "schnell" uf Hawaiianisch

CZ - WikiWiki znamena havajsky "rychle"

DE - WikiWiki ist das hawaiianische Wort fuer "sehr schnell".

DE/MOSELFRANCONIAN - WikiWiki hääst "flott" uff Hawaiioonisch

DE/SWABIAN - D'Hawaiianer said WikiWiki wenn ses eilig händ.

DE/SAXONIAN - WikiWiki sach'n de Hawaiianer wenn ses eilisch ham. 

DK - WikiWiki betyder "hurtig" på hawaiiansk.

ES - WikiWiki viene de "veloz" en hawaiano.

ESPERANTO - "WikiWiki" estas 'RapideRapide' en la Havaija lingvo.

EST - Havaii keeles WikiWiki tähendab <<kiiresti>>.

FI - WikiWiki on havaijin kieltä, ja tarkoittaa "nopea".

FL - Wiki is convenient and as easy as HTML!

FR - WikiWiki signifie "vite" en Hawaïen.

GA - WikiWiki an focal Haviiach ar "mear

GB - WikiWiki is the Hawaiian word for quick".

GEEK - "WikiWiki" == `nice -n 0`; // Wiki++

GL - WikiWiki quere dicir "veloz" en hawaiano.

GR - WikiWiki Ã?ìáßíåé "ãñ<THORN>ãï?" Ã??÷áâáíY´æéê?

GUJARATI - US na Hawaii tapu maa 'jaldi-jaldi' ne "WikiWiki" kahe chhe.

HE - "WikiWiki" means "?é÷ ?à÷" or "æøéæ"

HI - "WikiWiki" means "WikiWiki"

HINDI - Hawaii ki bhasha mein "jaldi jaldi", phataphat ko WikiWiki kehte hain!

HR - "WikiWiki" je havajska riječ za "brzo" 

HU - WikiWiki annyit jelent hawaii nyelven: "gyors"

IR - WikiWiki be zabane hawayi yani sari-tond-zood.

ICE - WikiWiki er hawaííska og þýðir hratt

IL - זה מהר WikiWiki

INA - WikiWiki merupakan kata dalam bahasa Hawaii yang berarti "cepat".

IT - WikiWiki è una parola Hawaiana che significa "veloce".

JAVANESE (not the Java by Sun Microsystems) - tegesipun WikiWiki inggih puniko 'enggal-enggal'

JBO la uiki,uikis cu mutce sutra

KALBO - Wiki TQ 

KONKANI- Hawaiintu WikiWiki mallari vaggi-vaggi monu arthu

KANNADA- Havwaii alli WikiWiki andare bega-bega anta artha

KOREAN- WikiWiki´Â ÇÏ¿ÍÀÌ¸»·Î '»¡¸®»¡¸®'¶Â?Â ¶æÀÔ´Ï´Ù.

LADAKHI- wikiwiki = "Gyospa"

LT - WikiWiki Havajieči� kalba reiškia "greitai".

LU - WikiWiki heescht "séier" op Hawaianëch.

MALAYALAM - Hawaiian bhashayil "WikiWiki" ennu paranjal "pettannu" ennu artham. 

MARATHI - Hawaii madhe pat pat la WikiWiki mhantat!

MK - WikiWiki na makedonski znaci brzo.

NL - WikiWiki is Hawaïaans voor "vlugvlug".

NO - WikiWiki er Hawaiisk for "hurtig".

NP - Nepalima 'wikiwiki' lai 'chito chito' bhancha

PIG LATIN - 'WikiWiki' isway Awai'ianhay orfay ickquay.

POL - "WikiWiki" to po hawajsku "szybko" (luzne tlumaczenie: dawaj, dawaj!)

PRC - Yong Hawaii ben di de yuyan, "WikiWiki" shi "kuai" de yisi

PT - WikiWiki é uma palavra Havaiana que significa "rápido".

PU - Wiki Daa Matlab Punjaabi Ch Hundaa Hai Jaldi

RO - "WikiWiki" inseamna "Repede" in dialectul hawaiian..

RU - WikiWiki значит "быстpо" на Гавайском языке. [znachit "bystro" na gavayskom yazyke]

SE - WikiWiki är Hawaiiska för "mycket snabb".

SELVIS - WikiWiki plernigrubn flobbn peissipeissi Hawaiischnorb

SI - WikiWiki v havajskem jeziku pomeni "hitro".

SINDHI - Hawaii ji bhasha mein "WikiWiki" jo matlab "jaldi" aahe.

SK - "WikiWiki" znamená v havajskom jazyku "rýchlo".

SR - "WikiWiki" na havajskom jeziku znaci "brzo"

SUNDANESE (not SUDANESE!) - WikiWiki hartina 'gancang euy!'

TAGALOG - WikiWiki ibig sabihin "madali" o "mabilis."

TAMIL - Hawaii mozhiyil "WikiWiki" endral viraivu endru poruL.

TELUGU - Hawaai lo "WikiWiki" antey "tondharaga" ani artham.

THAI - WikiWiki maay khwaam waa rew rew nai phaasaa Hawai'i.

TIGRINYA - Bequanqua Hawaii 'kiltuf' malet iyu.

TR - WikiWiki Hawaii dilinde "çabuk" anlamina gelir.

TWI - "WikiWiki" kyere se "ntentem" Hawai'i kasa mu.

Urdu 1- Jaldi ka matlab 'Wiki' Hawaiian mei.

Urdu - Wikki wikki "jaldi" kay liyay Hawaiian lafz hai

UK - Wiki is Hawiian for 'quick'

UK - Wikiwiki "'''instant'''"

UK Old School - "Weeny, Weedy, Wiki". I came, I saw, I chilled out.

US - WikiWiki means "Giddyup" in Ukulele-land.

US - Most excellent. yes it is

VI - WikiWiki c??? nghĩa l??? "nhanh nhanh" �? Hawaii.

ZA - Wikiwiki beteken "vinnig" in Afrikaans

ZAZAKI - zone Xawaiide mana xo "pet" o

AT - WikiWiki seems to sound similar to "vite vite"

ZH - WikiWiki 维基维基(translation) [weigi weigi] sounds like "危机 危机" => "crisis crisis" in English

ZH - What language support must a pc have to read this definition of Wiki Wiki? MP (''My google search is inconclusive: http://www.google.com/search?hl=en&lr=&q=country+abbreviation%2C+ZH&btnG=Search'' )
The following google search seems to indicate simple Chinese:
''http://www.google.com/search?hl=en&lr=&q=language+abbreviation%2C+ZH''
(Yeah, it's Chinese. And there are Chinese Simplified & Chinese Traditional...)

----
It is also short for WikiWikiWeb, see that page for more info. Some have used WikiWiki as a DramaticIdentity.
----
Quotes:

BAHASA - WikiWiki means 'pantas'/'cepat' in Bahasa Melayu

In Ukrainian, "WikiWiki" is baby talk.
